PROVIDERID
1003069535
1013019728
1013019728
1013173442
1013965482
1013965482
1013965482
1023067949
1043597131
1043597131
1043597131
1043597131
1043597131
1053590430
1053590430
1063686053
1063686053
1063686053
1063686053
1073788121
1073788121
1093806424
1093806424
1093806424
1093806424
1093806424
1093806424
1093806424
1093806424
1093806424
1093806424
1093806424
1093806424
1093806424
1093806424
1093806424
1093806424
1093806424
1093806424
1093806424
1093806424
1093806424
1093806424
1093806424
1093806424
1093806424
1093806424
1104106533
1124232137
1124279385
1134109861
1134109861
1134109861
1134109861
1134109861
1134109861
1134109861
1134109861
1134141039
1134141039
1134141039
1134141039
1134141039
1134141039
1134141039
1134141039
1134141039
1134141039
1134141039
1134141039
1134141039
1134141039
1134141039
1134141039
1134141039
1134141039
1134141039
1134141039
1134141039
1134141039
1134141039
1134141039
1134141039
1134141039
1134141039
1134141039
1134141039
1134141039
1134141039
1134141039
1134141039
1134141039
1134351430
1144282484
1154529501
1164499406
1194774166
1194986349
1215938857
1225017593
1225017593
1225017593
1225017593
1225017593
1225017593
1245373703
1245373703
1245373703
1245373703
1245373703
1245373703
1245373703
1245373703
1245373703
1245373703
1245373703
1245373703
1245373703
1245373703
1245373703
1245373703
1245373703
1245373703
1245373703
1245373703
1245373703
1245373703
1245373703
1245373703
1245373703
1245373703
1245373703
1245373703
1245373703
1245373703
1245373703
1245373703
1245373703
1245373703
1245373703
1245373703
1245373703
1245373703
1245373703
1245373703
1245373703
1245373703
1245373703
1245373703
1245373703
1245373703
1245373703
1245373703
1245373703
1245373703
1245373703
1245373703
1245373703
1245373703
1245373703
1245373703
1245373703
1245373703
1245373703
1245373703
1245373703
1245373703
1245373703
1245373703
1245373703
1245373703
1245373703
1245373703
1245373703
1245373703
1245373703
1245373703
1245373703
1245373703
1245373703
1255351235
1285609149
1285622621
1285767020
1285767020
1295020907
1295789527
1295889202
1295889202
1295889202
1295889202
1295889202
1295889202
1295889202
1295889202
1295889202
1295999183
1316906779
1316906779
1326350083
1326355835
1336110691
1336110691
1336303965
1336303965
1336303965
1336320860
1336434778
1356787972
1366412017
1366412017
1366412017
1366554867
1376899005
1386862639
1396925715
1407012149
1407012149
1417956509
1417956509
1417956509
1437340213
1447279237
1447279237
1447279237
1447279237
1447279237
1447279237
1447279237
1447279237
1447367479
1447367479
1447367479
1467774224
1467774224
1467774224
1467774224
1467774224
1467774224
1467774224
1467774224
1467774224
1467774224
1467774224
1467774224
1467774224
1467774224
1467774224
1467774224
1467774224
1467774224
1477667681
1518917939
1518917939
1518917939
1518917939
1518917939
1518917939
1518917939
1518917939
1518917939
1518917939
1518917939
1518917939
1518917939
1518917939
1518917939
1518917939
1518917939
1518917939
1538267745
1548205594
1548205594
1548291479
1588630743
1588745418
1588745418
1588745418
1588745418
1588745418
1588745418
1588745418
1588745418
1588745418
1598720971
1629207188
1629207188
1629224985
1639228661
1639228661
1639388226
1669773842
1669773842
1669773842
1669773842
1669773842
1669773842
1669773842
1669773842
1669773842
1669773842
1669773842
1700100690
1720046774
1750588901
1750588901
1750588901
1750588901
1750588901
1750588901
1760688592
1780650663
1780650663
1780944256
1790913648
1790932234
1790941466
1801056114
1801829510
1801875182
1811204076
1811204076
1821498023
1821498023
1821498023
1821498023
1821498023
1821498023
1821498023
1821498023
1821498023
1821498023
1821498023
1821498023
1821498023
1821498023
1821498023
1821498023
1821498023
1821498023
1831201433
1831345651
1841302346
1841369881
1841369881
1841369881
1841369881
1841369881
1881833747
1881833747
1881833747
1881833747
1881833747
1891756698
1891761953
1891987764
1932433745
1942238803
1942238803
1942238803
1942238803
1942238803
1942238803
1942311956
1942311956
1952421042
1952479776
1952569758
1952569758
1972769180
1972829687
